11 12 13 14 15 16 -1 18 -1 20
21 22 23 24 25 26 -1 28 -1 30
-1 32 -1 34 35 36 37 38 39 40
-1 42 -1 44 45 46 47 -1 -1 -1
51 52 53 54 55 56 57 58 59 -1
-1 62 -1 64 65 66 67 -1 -1 -1
-1 72 -1 74 75 76 77 78 79 80
-1 82 -1 84 85 86 87 88 89 90
